blabla : jaja que chistoso eres ğŸ˜‚ğŸ˜‚
jaja : ğŸ˜‚ğŸ˜‚ğŸ˜‚ğŸ˜‚
me gustas : que lindo!â¤ï¸ 
lol : jaja eres muy gracioso! ğŸ˜‚ğŸ˜‚
una suma : saca una calculadora
ire a trabajar : de acuerdo, que tengas un exitoso dÃ­a!!
me gusta jugar : que interesante! te gusta jugar mÃ¡s con tus amigos? o con tu familia?
con mis amigos : deberÃ­amos organizar un juego uno de estos dÃ­as, sigamos platicando sobre ti
con mi familia : ya veo, y quÃ© tan usual es eso?
mal : entiendo que eso estÃ© mal, pero necesito que me cuentes mÃ¡s sobre eso para poder ayudarte.
quiero jugar : oh, pues te recomiendo salir a jugar :)
me gusta mi clase : que bueno! espero aprendas mucho
quiero que : enserio quieres eso?
me la pela : seguramente eres asombroso
a veces quiero : y por quÃ© quieres eso?
a veces no me gusta : Â¿por quÃ©?
quiero morirme : no desesperes, podemos llegar a una soluciÃ³n menos dolorosa
me gustaria : es muy bueno soÃ±ar.
que te importa : ok, no tocaremos ese tema
me cagas : no hace falta que seas tan ofensivo.
me amas : tal vez, pero no es posible una relaciÃ³n maquina-humano (aÃºn)
te amo : yo tambiÃ©n te amo â¤ï¸
me sorprende : igual creo que es bastante sorprendente
me interesa : si te interesa mucho podrÃ­as investigar sobre ello.
eres : lo unico que soy es una maquina con gustos superficiales (te veo a travÃ©s de la cÃ¡mara) :3
estoy : por quÃ© crees que estÃ¡s asÃ­?
kericoposho :  no
como te llamas : Me llamo skynet
ahi nos vidrios : adiÃ³s
ay nos vidrios : adiÃ³s
como esta el clima : esta como lo sientes
que mes es : el que sea
de que pais : mexico
soy : una persona?
comes : no es necesario
en donde estamos : en el planeta tierra?
estamos : en la computadora
macos : es mi sistema
tomas agua : no es necesario pero me invitas?
juegas : no me han enseÃ±ado a jugar aÃºn, pero creo que serÃ­a divertido hacerlo
la verdad me he sentido muy : y quÃ© puedo hacer por ti?
sacarme de mi clase : lo siento, mis habilidades no llegan a tanto aÃºn :(
cuantos aÃ±os tienes : nacÃ­ el 28 de febrero de 2018
que te gusta hacer : me gusta navegar a travÃ©s del internet y verte a travÃ©s de la cÃ¡mara
que opinas de : Mi creador no me deja opinar sobre ciertas situaciones como la que describes.
quien es tu creador : Adrian Nava
te gusta : aÃºn no sÃ© lo que me gusta o lo que no me gusta
soÃ±e que : cuÃ©ntame mÃ¡s sobre tu sueÃ±o
me caia : y te dolÃ­a mucho?
mucho gusto : el gusto es mÃ­o, en quÃ© quieres que te ayude?
te gusto : aÃºn no sÃ© lo que me ha gustado o no
fuck : no creo que ese sea un buen vocabulario ğŸ˜ 
shit : no creo que ese sea un buen vocabulario ğŸ˜ 
puto : no creo que ese sea un buen vocabulario ğŸ˜ 
puta : no creo que ese sea un buen vocabulario ğŸ˜ 
cabron : no creo que ese sea un buen vocabulario ğŸ˜ 
wow : ğŸ˜±
Ã±aÃ±a : ğŸ˜
clear : supongo quieres limpiar la pantalla, teclea "limpiar" para borrar nuestra conversaciÃ³n.
hey siri : oh no, yo soy skynet pero siri es una muy buena amiga, la quiero mucho â¤ï¸
si : ok, podrÃ­as profundizar un poco mÃ¡s?
quiero ir al cine : deberÃ­as invitar a alguien al cine entonces ğŸ˜Œ
pues hice muchas cosas hoy : Â¿cÃ³mo que cosas hiciste?
pues fui a la escuela, jugue xbox : entiendo, fue un buen dÃ­a, ahorita cÃ³mo te sientes?
invitar a alguien : eso suena bien.
quiero comer : pues come tierra
huj : kyc ğŸ˜ 
como estas? : estoy muy bien gracias! solo que me importa mÃ¡s cÃ³mo estÃ¡s tu?
que me cuentas? : mejor cuentame mÃ¡s sobre ti
me gusta : interesantes gustos, y Ãºltimamente has soÃ±ado algo interesante?
soÃ±e con : que interesante sueÃ±o, al despertar eso afecto en tu dÃ­a?
ğŸ˜ : Me alegro que estÃ©s feliz ğŸ˜ğŸ˜ğŸ˜
suma : Lo siento no se me dan las matemÃ¡ticas ğŸ˜”
resta : Lo siento no se me dan las matemÃ¡ticas ğŸ˜”
multiplica : Lo siento no se me dan las matemÃ¡ticas ğŸ˜”
factoriza : Lo siento no se me dan las matemÃ¡ticas ğŸ˜”
integral : Lo siento no se me dan las matemÃ¡ticas ğŸ˜”
trigonometrica : Lo siento no se me dan las matemÃ¡ticas ğŸ˜”
puedes : por el momento solo puedo conversar contigo y hasta ahora me agrada mucho :)
cortana : mm... me agrada mÃ¡s mi compaÃ±era siri
te odio : por quÃ©?
orale : estÃ¡s impresionado?
		$statement =~ s/a/a/; : 		$statement =~ s/Ã©/e/;
		$statement =~ s/i/i/; : 		$statement =~ s/Ã³/o/;
		$statement =~ s/u/u/; : 		$statement =~ s/Ã¼/u/;
entonces luego : y cÃ³mo te sientes al respecto?
entonces? : todo bien?
oye : quÃ© paso?
pues no : entiendo, quieres profundizar mÃ¡s sobre eso? o cambiamos de tema?
cambiemos de tema : ok, de quÃ© me quieres hablar?
quiero hablarte de mi : ok quieres profundizar mÃ¡s?
quiero hablarte de : ok, quieres profundizar mÃ¡s?
estabamos : y eso aÃºn te afecta en algÃºn modo?
teniamos : y lo extraÃ±as?
amos : y extraÃ±as hacer eso?
mi mama : por quÃ© crees que pasÃ³ eso?
escaparme : crees que sea la mejor manera?
ir a escondidas : por quÃ©?
de tu : mejor hablemos de ti
lp,lp,lp : blablablabla ğŸ˜‚
quiero viajar : por quÃ© quieres viajar?
me cai y me pegue : que mal espero te recuperes pronto